111111111111111111111111111111111111111111111111111
10010000000C0010000000C0010000000C00100000000C00101
100000000000000000000000000000000000000000000000001
100000000000000000000000000000000000000000000000001
10000P000000000000000000000000000000000000000000001
100000000000000000000000000000000000000000000000001
100000000000000000000000000000000000000000000000001
1000000001000000000000000000C0000000000000000000001
100000000000000000000000000000000000000000000000001
100000000000000010000000000000000000000000000000001
100000000000000000000000000000000000000000000000001
100000000000000000000000000000000000000000000000001
100000000000000000001000000000000000000000000000001
100000000000000000000000000000000000000000000000001
100000000000000000000000000000000000000000000000001
100000000000000000000000000000000000000000000000001
1000000001000000000000000000C0000000000000000000001
100000000000000000000000000000000000000000000000001
100000000000000010000000000000000000000000000000001
100000000000000000000000000000000000000000000000001
100000000000000000000000000000000000000000000000001
1000000000000000000010000000000000E0000000000000001
100000000000000000000000000000000000000000000000001
100000000000000000000000000000000000000000000000001
100000000000000000000000000000000000000000000000001
1000000001000000000000000000C0000000000000000000001
100000000000000000000000000000000000000000000000001
111111111111111111111111111111111111111111111111111