11111111111111
100100000000C1
10000111110011
1P0011E0000011
10000000000001
11111111111111

